Postiljonen - The Open Road
My Morning Jacket - Compound Fracture
Pinkshinyultrablast - Holy Forest
Braids - Blondie
Pink Skull - Poly-Mono
Haiku Salut - Hearts Not Parts
Young Fathers - Nest
Matthew Halsall, Gondwana Orchestra, Josephine Oniyama - Badder Weather (feat. Josephine Oniyama)
Samba Touré - Gandadiko
Bop English - The Hardest Way
Susanne Sundfør - Fade Away
Crazy P - Something More
The Very Best - Let Go
SEXWITCH - Ha Howa Ha Howa
Gilligan Moss - Choreograph
Lupe Fiasco - Deliver
Songhoy Blues - Soubour
Andreya Triana - Gold
Wolf Alice - Bros
Lanterns on the Lake - Faultlines
Sufjan Stevens - Should Have Known Better
Nils Frahm - Four Hands
Floating Points - Peroration Six
Zun Zun Egui - Rigid Man
Algiers - Irony. Utility. Pretext.
Helena Hauff - L'Homme Mort
Bxentric - Chrome
Rae Morris - Under The Shadows
Girls Names - Zero Triptych
St Germain - Real Blues
Lucy Rose - Like an Arrow
Sundara Karma - Loveblood
Father John Misty - Chateau Lobby #4 (in C for Two Virgins)
Lone Wolf - Mistakes
Errors - Lease Of Life
Ella Eyre - Always
Harry Shotta Show - Animal
Blanck Mass - Cruel Sport
Girl Band - Paul
Teeth Of The Sea - Animal Manservant
Spectres - Blood In The Cups
The Flowers Of Hell - Warmth of a Christmas Chill
Kamasi Washington - Change of the Guard
Billie Marten - Heavy Weather
Death Cab for Cutie - Black Sun
The Go! Team - The Scene Between
New Order - Plastic
Oklo Gabon - City Gym
Denai Moore - Blame
Foals - Mountain At My Gates
Greg Wilson, Reynolds - Summer Came My Way - Luxxury Radio Mix
Jamie xx, Romy - Loud Places
City and Colour - Northern Blues
Hanni El Khatib - Two Brothers
Tei Shi - Bassically
Vessels - Attica
Bicep - Back 2 U
Nelver, Simplification - New York
DJ Koze - Knee on Belly
JME - Pulse 8
HEALTH - NEW COKE
Worriedaboutsatan - Jaki
Sleaford Mods - No One's Bothered
Ghostface Killah, BadBadNotGood, Doom - Ray Gun (feat. DOOM)
GoGo Penguin - All Res
Föllakzoid - Feuerzeug
Public Service Broadcasting - Korolev
The Julie Ruin - Blueberry Island
Joey Bada$$ - On & On (feat. Maverick Sabre & Dyemond Lewis)
Joanna Gruesome - Honestly Do Yr Worst
Lightning Bolt - Over The River And Through The Woods
Courtney Barnett - Depreston
EL VY - Return to the Moon (Political Song for Didi Bloome to Sing, with Crescendo)
Shura - White Light
Mark McGuire - The Undying Stars
Romare - Roots
Mbongwana Star - Kala
A Sunny Day In Glasgow - I Can't Live Without Your Love
Beck - Dreams
Bleachers, Natalie Maines - Who I Want You to Love
Low - Lies
Ludovico Einaudi, Daniel Hope - Petricor
Majical Cloudz - Downtown
µ-Ziq - XT
Holly Herndon - Morning Sun
Colin Stetson, Sarah Neufeld - The Rest of Us
Snts - ES19.1
Lids, Metz, Holy Fuck, Constantines - Sarsfest
VoX LoW - Something is Wrong
Squarepusher - Stor Eiglass
Godspeed You! Black Emperor - Piss Crowns Are Trebled
Metz - Acetate
PINS - Baby Bhangs
Kendrick Lamar - King Kunta
Grimes, Bleachers - Entropy
Hanna Järver - Samma Gamla Himmel
Kiasmos - Swept
Julia Kent - Terrain
Richard Hawley - I Still Want You
Iron & Wine, Ben Bridwell - This Must Be The Place
