Steve Mason - Lost And Found 
Seu Jorge - Errare Humanum Est 
Caribou - Odessa 
Janelle Monáe - Dance or Die - feat. Saul Williams 
Booka Shade - Regenerate - Popof Remix 
Kid Cudi - Mojo So Dope 
Holly Miranda - Waves 
Four Tet - Love Cry - Joy Orbison remix 
Ali Farka Touré - Warbé 
Efterklang - Modern Drift 
Tensnake - Coma Cat 
Errors - A Rumour In Africa 
Pretty Lights - Understand Me Now 
School Of Seven Bells - Babelonia 
Neil Young - Sign Of Love 
The Knife - Colouring Of Pigeons 
Laura Marling - Devil's Spoke 
Ariel Pink's Haunted Graffiti - Round And Round 
The Roots - Right On 
Cheikh Lo - Il N'est Jamais Trop Tard 
Broken Bells - The High Road 
Nightlands - 300 Clouds 
Isobel Campbell & Mark Lanegan - Snake Song 
LCD Soundsystem - You Wanted A Hit 
Cee Lo Green - Fuck You 
Aeroplane - London Bridge 
Gorillaz - Stylo (feat. Mos Def and Bobby Womack) 
The Juan Maclean - Feel So Good (DJ-KiCKS) 
Trentemøller - Silver Surfer, Ghost Rider Go!!! - Original Mix 
Sleigh Bells - Tell 'Em 
Holy Fuck - Latin America 
Massive Attack - Paradise Circus - Breakage's Tight Rope Remix 
Diskjokke - Big Flash 
Dungen - Blandband 
Gil Scott-Heron - Me And The Devil 
Matt and Kim - AM/FM Sound 
Fliptrix - You'll Never Change 
Krooked - You Cry 
Crystal Castles - Not In Love 
Factory Floor - Lying 
Foreign Beggars - Contact 
Gui Boratto - I Feel Love - Robert Babicz Earth Remix 
Jónsi - Boy Lilikoi 
Fever Ray - Mercy Street 
Robert Plant - Silver Rider 
Yann Tiersen - Amy 
Pantha Du Prince - Lay In A Shimmer 
Mulatu Astatke - Mulatu's Mood 
To Rococo Rot - Away 
K-X-P - Elephant Man 
Salem - Redlights 
Plan B - The Recluse - Nero Remix 
Pyramid - Rain - Original Mix 
Nedry - Apples & Pears 
Georgia Anne Muldrow - The Black Mother 
PVT - Crimson Swan 
Kjex - Bluecheeseblues Part2 
Delorean - Simple Graces 
KEITH CANISIUS - Gentle Guys 
Totally Enormous Extinct Dinosaurs - Waulking Song 
Prins Thomas - Don't Hang The DJ (Blame The Producer) 
Karen Elson - The Ghost Who Walks 
Jon Kennedy - Live Test 
Michal Menert - Starfall 
Ital Tek - Infinity 
Muffler - Kolga 
Noisia - Red Heat 
Reso - Boriken Groove 
Jack Beats - Out of Body 
We Have Band - Divisive 
Vent - Lunatics 
Archie Bronson Outfit - Shark's Tooth 
HoldTight - Lounge - DC Breaks Remix 
Blende - Fluttery Will Get You Nowhere 
The Black Keys - Next Girl 
Funki Porcini - This aint the way to live 
Charlotte Gainsbourg - Voyage 
Shit Robot - Triumph!!! 
Bot'Ox - Blue Steel (feat. Anna Jean) 
Bachelors of Science - Bombay Sapphire 
Cosmin TRG - Discotek 
Blackbird Blackbird - Pure 
The Qemists - Hurt Less 
Femi Kuti - Yeparipa 
The Ruby Suns - Dusty Fruit 
Washed Out - Hold Out 
The Besnard Lakes - Like The Ocean, Like The Innocent Pt. 2: The Innocent 
Luciano - It Won't Be Long 
The Pains Of Being Pure At Heart - Say No To Love 
Citay - Hunter 
Glasser - Apply 
Rebel Sonix - Looking Back 
Future Engineers - Side-Effects (Electrosoul System Remix) 
Small Black - Photojournalist 
Emeralds - Goes By 
Hammock - The World We Knew As Children 
Toots & The Maytals - Almighty Way 
