Night Swim - Frankie Rose
Diamondback (Part 1 & Part 2 - Extended Single Version) - (Part 1 & Part 2 - Extended Single Version) - Sare Havlicek
Pleasure Palaces - Errors
My Advice - Peter Visti
When The Past Was Present - John Talabot
Out of Line - Brothertiger
OC DC - Get The Blessing
De Javu - Mark McGuire Remix - Lindstrøm
Mallet - Walton
Changuito - Mala
Tessellate - alt-J
Vultures - Sennen
Black Doe - Mary Epworth
Goatman - Goat
Dougou Badia - feat. Santigold - Amadou & Mariam
Pushin` Aside, Pushin` Along - De La Soul`s Plug 1 & Plug 2 present First Serve
Dream Beat - Peaking Lights
Current - Jonas Munk
London Can Take It - Public Service Broadcasting
White Math - Blanck Mass
Beelzedub - Orbital
Be Loved - Richard Fearless & Death in Vegas Remix - Headman aka Robi Insinna
Her Fantasy - Matthew Dear
Waterfront - Enjoyed
Dark Star - POLIÇA
Underbelly - The Slow Waves
Brats - Liars
Walking Up To Hand Grenades - The Brian Jonestown Massacre
The Night - School Of Seven Bells
Summer's Glory - Alcest
Running - Jessie Ware
Show Me Everything - Tindersticks
Monoliths - Lotus Plaza
Heaven - The Walkmen
Motion Sickness - Hot Chip
Don't Wait - Extended Mix - Alex Niggemann
Stardust - Kolombo Remix - Cosmonauts
Circumambient - Grimes
Get On It - Ruby Goe
Under The Bridges - Niki & The Dove
Major - The Asteroids Galaxy Tour
Twins - Ultrasound
Little Talks - Of Monsters and Men
Hold On - Alabama Shakes
Wrecking Ball - Bruce Springsteen
Fire's Highway - Japandroids
How Do I Know - Here We Go Magic
Varúð - Sigur Rós
To a Poet - First Aid Kit
We Got It Wrong - Original Version - St. Lucia
Meeting Point - Utah Saints Remix - Drumattic Twins
Gospel - Ross Caiden Remix - Tiger Stripes
Just to Feel Anything - Emeralds
Crashed - Stay+
Eraser - Neonlight Remix - Black Sun Empire
Nexecution - Neonlight
Let's Die - Turbowolf
ill Manors - Plan B
Doom And Gloom - Jeff Bhasker Mix - The Rolling Stones
Njoka - Mokoomba
Avatar - Swans
Endless Ladder - The Antlers
Dreams Today - Efterklang
R. Mullen - Yppah
Toothless Grin - Jinja Safari
Swimmers - Echo Lake
Bleeding Muddy Water - Mark Lanegan
Blue Narcissus - Omega Male
Request Denied - El-P
Big Beast - feat. Bun B, T.I., and Trouble - Killer Mike
Exoframe - Reso
Icarus - Madeon
Crystal Caverns 1991 - Lone
Hornet Head - Rene Lavice
First Snow - Original Mix - Chris.su
The Same Disease - Michal Menert
Catch - Psychemagik Remix - The Egg
Good Morning - Leftside Wobble Remix - The Time And Space Machine
Ruins - Portico Quartet
Heart Full of Love - Fliptrix
Make It Happened (Original Mix) - BadBoe
The Guillotine - The Coup
Autumn dub VIP - VIP Mix - Mooncat
Travelling Song - Quantic
Wait - Diiv
Wasted Days - Cloud Nothings
Mladic - Godspeed You! Black Emperor
Ashen Snow - Dirty Three
Leave Your Body Behind You - Richard Hawley
Sparkly - Young Magic
Cheree - Füxa
Straight Back - Washed Out
1998 (Delicious) - Peace
Valentina - Iñigo Ugarteburu
Make You Feel Better - Cashier No. 9
Lazy Hunter - Boy Friend
Ten Thousand Years Won't Save Your Life - Hammock
Atmosphere - The Flowers Of Hell
