Take a Look Around - The 2 Bears
You Know You Like It - DJ Snake
Parentheses - The Antlers
Another Time, Another Place - Arnaud Rebotini
Perfectly Crystal - Asobi Seksu
Reckless (With Your Love) - Tensnake Remix - Azari & III
Hey Anna Lena - Bell X1
Heavy Industry - The Black Dog
Calgary - Bon Iver
Les Paul Custom '86 - Boris
Lavender - Blawan
Teufelsleiter - The Brandt Brauer Frick Ensemble
The Alliance (feat Talib Kweli) - Break Science
Ghost Story - Cloud Control
You And I Change Like Seasons - Codes In The Clouds
Cycle Eyes - Psychemagik Lagoon Nebula Mix - Cosmonauts
Go Outside - Cults
Palinopsia Intro/Almost Out of Time - D'eon
Love/Lust - D/R/U/G/S
Your Loft My Acid - Death In Vegas
Don't Carry It All - The Decemberists
Trumpalump - Joe Goddard Remix - Dels
Etran Duniya - The Dhol Foundation
Waveforms - Django Django
Die 3 Millionen Musketiere - Dominik Eulberg
Complicity - The Early Years
Chrysalis Records - Egyptrixx
My Mistakes - Eleanor Friedberger
With Our Backs To The City - Epic45
Righteous featuring Danman - Main Mix - Evergreen, Landlord & Ruckspin
(R E A L L O V E) - Factory Floor
Makoun Oumou - Fatoumata Diawara
The Plains / Bitter Dancer - Fleet Foxes
Rivers - Frank Turner
Under My Nose - Fucked Up
EST - Gentleman's Dub Club
Dead Man's Switch - Ghosting Season
Up Up Up - Givers
Buy Nothing Day - The Go! Team
Sagrad Прекрасный - Grimes
Tongue Tied - Grouplove
These Are The Good Days - Gwilym Simcock
Sceadu - Helge Lien Trio
Still Life - The Horrors
Phoenix - Hyetal
Winter Beats - I Break Horses
Still Unloved - Icr
Oxblood - Implodes
Tree By The River - Iron & Wine
Salty Air - J.Viewz
Street - Jamie Woon
Gabriel - Joe Goddard
Prizewinning - Julianna Barwick
Supernova - Karsh Kale
Snowflake - Kate Bush
Society Is My Friend - Kurt Vile
Courage - Kyla La Grange
I Feel It - L-Vis 1990
Rise (feat. KRS ONE, A.P.O.S.T.L.E. & Stero-Lion) - Liquid Stranger
Tale Of The Rogue Synth - Original Mix - Lord Of The Isles
Witches - Low
Ok Pal - M83
Can't Leave You - Maceo Plex
We Are You in the Future - Martyn
Get Right - Megafaun
Africa - Rotciv Remix - Mirror People
Mexican Grand Prix - Mogwai
Explain - Oneohtrix Point Never
Alabama Dice - Pional
Written On The Forehead - PJ Harvey
Staircase - Radiohead
How Deep Is Your Love? - The Rapture
It's Real - Real Estate
Star featuring Tony Momrelle - Manuel Tur Remix - Reel People
War Machine - Reso
Sanctuary (feat. Jessie Ware and Sampha) - SBTRKT
Two Cousins - Slow Club
Chunky Guitar - Space Ranger
Pull The House Down - Skellington Remix - Stricken City
All Yours - Original Mix - Submotion Orchestra
Arcane - Supervision
Ultra Light - Surkin
Aratan N Tinariwen - Tamikrest
Tenere Taqqim Tossam - Tinariwen
Take It Back - Toddla T
Birds - Tiago Remix - Torn Sail
My Country - tUnE-yArDs
Caffeinated Consciousness - TV On The Radio
Chasing Rainbows - Ulrich Schnauss, Jonas Munk
I Am Not Like You - Ilya Santana Remix - Volta Cab
Eyes Be Closed - Washed Out
Mad As the Mist and Snow - The Waterboys
Brothers - The War On Drugs
Where Are Your People? - We Have Band
Flight - Wooden Shjips
Montana - Youth Lagoon
Vessel - Zola Jesus
Mr. Brown - Zun Zun Egui
