Sinkane - How We Be 
Fujiya & Miyagi - Little Stabs At Happiness 
Total Control - Glass 
Matthew Dear - Drop Science 
El Ten Eleven - Reprise 
Alex Banks - Initiate 
GoGo Penguin - Murmuration 
Aphex Twin - CIRCLONT6A [141.98][syrobonkus mix] 
Young Fathers - NO WAY 
Robert Plant - Little Maggie 
Joana Serrat - The Blizzard 
José González - This Is How We Walk On The Moon 
Get The Blessing - Little Ease 
Shabazz Palaces - Motion Sickness 
September Girls - Cursing the Sea 
The War On Drugs - Burning 
Panda Bear - Mr Noah 
Alvvays - Archie, Marry Me 
Spoon - Inside Out 
Frankie Forman - Scars On Me 
Highasakite - Leaving No Traces 
First Aid Kit - My Silver Lining 
Jamie T - Zombie 
Pixies - Blue Eyed Hexe 
Wolf Alice - Moaning Lisa Smile 
Perfect Pussy - Work 
The Raveonettes - Sisters 
A Sunny Day In Glasgow - The Body, It Bends 
The Pains Of Being Pure At Heart - Beautiful You 
tUnE-yArDs - Water Fountain 
Perfume Genius - Queen 
Parastatic - Oscillations 
Chet Faker - Gold 
Future Islands - Seasons (Waiting On You) 
40 Thieves - Face Full of Fur 
AK/DK - Maxwell's Waves 
Wesley Matsell - Total Order of Being 
Mogwai - Remurdered 
Caribou - Can't Do Without You 
Jungle - Busy Earnin' 
La Roux - Uptight Downtown 
MØ - Red in the Grey 
Moko - Ceremony 
Muffler - Start Line 
Optiv - Heartshaped 
The Upbeats - Rituals 
Nu Tone - Bern - Original Mix 
Reso - Break 'em 
Ital Tek - Swamp Beat 
Pye Corner Audio - Perfect Secrecy Forever 
Kiasmos - Bent 
The Emperor Machine - Rmi Is All I Want 
Spank Rock - Gully (Brodisnki Remix) 
Plaid - Hawkmoth 
Woman's Hour - Conversations (Fort Romeau Remix) 
Lana Del Rey - West Coast 
Helge Lien Trio - The New Black 
Beck - Blue Moon 
Alcest - Opale 
Mac Demarco - Blue Boy 
Eagulls - Nerve Endings 
Haley Bonar - Send Me to The 'Lectric Chair 
Goat - Goatslaves 
White Lung - In Your Home 
Wye Oak - Glory 
Yann Tiersen - Steinn 
East India Youth - Hinterland 
Sleazy Mcqueen - Bittersweet Freedom - Original Mix 
Floating Points - King Bromeliad 
Die Antwoord - Ugly Boy 
Wu-Tang Clan - Ruckus In B Minor 
Bruce Springsteen - Harry's Place 
The Men - Another Night 
Nick Mulvey - Juramidam 
Neil Cowley Trio - Queen 
Mirel Wagner - Oak Tree 
Savages - Fuckers 
Swans - A Little God In My Hands 
Decapitated - Blindness 
Ben Frost - Secant 
Flowdan - People Power 
Run The Jewels - Close Your Eyes (And Count to Fuck) [feat. Zack De La Rocha] 
Forbidden Society - Criminal - Original Mix 
Neonlight - Transit 
Black Monolith - Victims & Hangmen 
Behemoth - Ora Pro Nobis Lucifer 
Esben and the Witch - No Dog 
Owen Pallett - The Riverbed 
Lewis Fautzi - UVB-76 
Dusty Kid - Doom 
Liars - Mask Maker 
Simple Minds - Blindfolded 
Dark Sky - Silent Fall 
D'Angelo - Ain't That Easy 
Matthew Halsall - When the World Was One 
Melanie De Biasio - Sweet Darling Pain 
Mark McGuire - The Instinct 
Spotlight Kid - Hold On 
A Winged Victory for the Sullen - Atomos II 
Lucy Claire - Somnus - Bruised Skies rework 
