The Trip - Still Corners
Stay / True - Fort Romeau
The Only Shrine I've Seen - Darkside
These Shadows - Wooden Shjips
Barrier Islands (Do We Remain) - The Appleseed Cast
The Revival - Hidden Orchestra
Colour Yr Lights In - The Besnard Lakes
Red Eyes - The War On Drugs
Imanin bas zihoun - Tamikrest
Bagboy - Pixies
Hare Tarot Lies - No Joy
Beglammered - The Asphodells (Andrew Weatherall & Timothy J Fairplay)
Touching - Raffertie
They Won't See Me - The Field
9 - Föllakzoid
Big Love - Matthew E. White
If I Were A Carpenter - Smoke Fairies
Ghost Mountain You And Me - Thought Forms
Open Eye Signal - Jon Hopkins
We Live - 126 Refix - Greg Packer
Brainfreeze - Fuck Buttons
Prisms - 65daysofstatic
Punk Music Mass - AK/DK
Inhaler - Foals
Amanda In the Clouds - Panda Riot
Things Are Sometimes Tragic - Team Ghost
Billions - Forrests
Cirrus - Bonobo
Bad Kingdom - Moderat
Somebody Who - Au Revoir Simone
Falling - Haim
Ohm - Yo La Tengo
Special N - Mogwai
Wakin on a Pretty Day - Kurt Vile
Sounds Like There's A Pacman Crunching Away At Your Heart - Haiku Salut
Son of a Bitch - Highasakite
Afterlife - Arcade Fire
My Baby Just Sailed Away - Black Hearted Brother
Spiral - Todd Terje
Spitfire - Public Service Broadcasting
White Noise - Disclosure
Bapasi - Jupiter & Okwess International
Where Do We Go from Here (feat. Menahan Street Band) - Charles Bradley
Jubilee Street - Nick Cave & The Bad Seeds
Where Are We Now? - David Bowie
Run Boy Run - Woodkid
Gamo - Mulatu Astatke
People Will Say - Benin City
Release! - Melt Yourself Down
Ghost Town - Maldini
Hate Or Glory - Gesaffelstein
Make Those Move - I Am Legion
Come Down to Us - Burial
Bleep Five - The Black Dog
Reaper - Teeth Of The Sea
Inner Babylon - Sons Of Kemet
Renata - Holden
Badman City - Kahn
So Inspired To Fail - Rene Lavice
Still On Fire - Trentemøller
Spiral Code - God Is An Astronaut
Mr. Martyr - Young Fathers
New Seeds - Boards of Canada
Fall Back - Factory Floor
V (Island Song) - These New Puritans
Dancing Light - Grumbling Fur
Stay True - PINS
Spit Dirt - His Electro Blue Voice
In Awe Of - Cult Of Luna
I Come From The Mountain - Thee Oh Sees
Fire! - Steve Mason
The Throw - Jagwar Ma
Survive - Kidnap Kid
The Only Constant Is Change - Kris Menace
Spectral Split - Pantha Du Prince & The Bell Laboratory
Brennisteinn - Sigur Rós
You Show Great Spirit - Prurient
Full of Fire - The Knife
Out of Sight - The Bloody Beetroots
Aurora - Camo & Krooked
Hemlock - Concord Dawn
Video Siren - Gary Beck
White Ropes - Mixhell
On My Own - Dub Version - Zero 7
Recollection - Keep Shelly In Athens
Moonshine Got Me (Live) - Daniel Norgren
Coming Through - Willis Earl Beal feat. Cat Power
The Corner Man - Barrence Whitfield & The Savages
Hipsko (feat. The Time Travellas) - Timewarp Inc
One Girl / One Boy - !!!
Hearts Like Ours - The Naked And Famous
Green And Gold - Lanterns on the Lake
Bibisa - Roberto Fonseca
Penitentiary - Houndmouth
What Death Leaves Behind - Los Campesinos!
We Are Explorers - Cut Copy
This Is The Last Time - The National
Help - Postiljonen
Look Into Your Own Mind - Julianna Barwick
