Somnus - Bruised Skies rework - Lucy Claire
Atomos II - A Winged Victory for the Sullen
Hold On - Spotlight Kid
The Instinct - Mark McGuire
Sweet Darling Pain - Melanie De Biasio
When the World Was One - Matthew Halsall
Ain't That Easy - D'Angelo
Silent Fall - Dark Sky
Blindfolded - Simple Minds
Mask Maker - Liars
Doom - Dusty Kid
UVB-76 - Lewis Fautzi
The Riverbed - Owen Pallett
No Dog - Esben and the Witch
Ora Pro Nobis Lucifer - Behemoth
Victims & Hangmen - Black Monolith
Transit - Neonlight
Criminal - Original Mix - Forbidden Society
Close Your Eyes (And Count to Fuck) [feat. Zack De La Rocha] - Run The Jewels
People Power - Flowdan
Secant - Ben Frost
Blindness - Decapitated
A Little God In My Hands - Swans
Fuckers - Savages
Oak Tree - Mirel Wagner
Queen - Neil Cowley Trio
Juramidam - Nick Mulvey
Another Night - The Men
Harry's Place - Bruce Springsteen
Ruckus In B Minor - Wu-Tang Clan
Ugly Boy - Die Antwoord
King Bromeliad - Floating Points
Bittersweet Freedom - Original Mix - Sleazy Mcqueen
Hinterland - East India Youth
Steinn - Yann Tiersen
Glory - Wye Oak
In Your Home - White Lung
Goatslaves - Goat
Send Me to The 'Lectric Chair - Haley Bonar
Nerve Endings - Eagulls
Blue Boy - Mac Demarco
Opale - Alcest
Blue Moon - Beck
The New Black - Helge Lien Trio
West Coast - Lana Del Rey
Conversations (Fort Romeau Remix) - Woman's Hour
Hawkmoth - Plaid
Gully (Brodisnki Remix) - Spank Rock
Rmi Is All I Want - The Emperor Machine
Bent - Kiasmos
Perfect Secrecy Forever - Pye Corner Audio
Swamp Beat - Ital Tek
Break 'em - Reso
Bern - Original Mix - Nu Tone
Rituals - The Upbeats
Heartshaped - Optiv
Start Line - Muffler
Ceremony - Moko
Red in the Grey - MØ
Uptight Downtown - La Roux
Busy Earnin' - Jungle
Can't Do Without You - Caribou
Remurdered - Mogwai
Total Order of Being - Wesley Matsell
Maxwell's Waves - AK/DK
Face Full of Fur - 40 Thieves
Seasons (Waiting On You) - Future Islands
Gold - Chet Faker
Oscillations - Parastatic
Queen - Perfume Genius
Water Fountain - tUnE-yArDs
Beautiful You - The Pains Of Being Pure At Heart
The Body, It Bends - A Sunny Day In Glasgow
Sisters - The Raveonettes
Work - Perfect Pussy
Moaning Lisa Smile - Wolf Alice
Blue Eyed Hexe - Pixies
Zombie - Jamie T
My Silver Lining - First Aid Kit
Leaving No Traces - Highasakite
Scars On Me - Frankie Forman
Inside Out - Spoon
Archie, Marry Me - Alvvays
Mr Noah - Panda Bear
Burning - The War On Drugs
Cursing the Sea - September Girls
Motion Sickness - Shabazz Palaces
Little Ease - Get The Blessing
This Is How We Walk On The Moon - José González
The Blizzard - Joana Serrat
Little Maggie - Robert Plant
NO WAY - Young Fathers
CIRCLONT6A [141.98][syrobonkus mix] - Aphex Twin
Murmuration - GoGo Penguin
Initiate - Alex Banks
Reprise - El Ten Eleven
Drop Science - Matthew Dear
Glass - Total Control
Little Stabs At Happiness - Fujiya & Miyagi
How We Be - Sinkane







2010

Almighty Way - Toots & The Maytals
The World We Knew As Children - Hammock
Goes By - Emeralds
Photojournalist - Small Black
Side-Effects (Electrosoul System Remix) - Future Engineers
Looking Back - Rebel Sonix
Apply - Glasser
Hunter - Citay
Say No To Love - The Pains Of Being Pure At Heart
It Won't Be Long - Luciano
Like The Ocean, Like The Innocent Pt. 2: The Innocent - The Besnard Lakes
Hold Out - Washed Out
Dusty Fruit - The Ruby Suns
Yeparipa - Femi Kuti
Hurt Less - The Qemists
Pure - Blackbird Blackbird
Discotek - Cosmin TRG
Bombay Sapphire - Bachelors of Science
Blue Steel (feat. Anna Jean) - Bot'Ox
Triumph!!! - Shit Robot
Voyage - Charlotte Gainsbourg
This aint the way to live - Funki Porcini
Next Girl - The Black Keys
Fluttery Will Get You Nowhere - Blende
Lounge - DC Breaks Remix - HoldTight
Shark's Tooth - Archie Bronson Outfit
Lunatics - Vent
Divisive - We Have Band
Out of Body - Jack Beats
Boriken Groove - Reso
Red Heat - Noisia
Kolga - Muffler
Infinity - Ital Tek
Starfall - Michal Menert
Live Test - Jon Kennedy
The Ghost Who Walks - Karen Elson
Don't Hang The Dj (Blame The Producer) - Prins Thomas
Waulking Song - Totally Enormous Extinct Dinosaurs
Gentle Guys - KEITH CANISIUS
Simple Graces - Delorean
Bluecheeseblues Part2 - Kjex
Crimson Swan - PVT
The Black Mother - Georgia Anne Muldrow
Apples & Pears - Nedry
Rain - Original Mix - Pyramid
The Recluse - Nero Remix - Plan B
Redlights - Salem
Elephant Man - K-X-P
Away - To Rococo Rot
Mulatu's Mood - Mulatu Astatke
Lay In A Shimmer - Pantha Du Prince
Amy - Yann Tiersen
Silver Rider - Robert Plant
Mercy Street - Fever Ray
Boy Lilikoi - Jónsi
I Feel Love - Robert Babicz Earth Remix - Gui Boratto
Contact - Foreign Beggars
Lying - Factory Floor
Not In Love - Crystal Castles
You Cry - Krooked
You'll Never Change - Fliptrix
AM/FM Sound - Matt and Kim
Me And The Devil - Gil Scott-Heron
Blandband - Dungen
Big Flash - Diskjokke
Paradise Circus - Breakage's Tight Rope Remix - Massive Attack
Latin America - Holy Fuck
Tell 'Em - Sleigh Bells
Silver Surfer, Ghost Rider Go!!! - Original Mix - Trentemøller
Feel So Good (DJ-KiCKS) - The Juan Maclean
Stylo (feat. Mos Def and Bobby Womack) - Gorillaz
London Bridge - Aeroplane
Fuck You - Cee Lo Green
You Wanted A Hit - LCD Soundsystem
Snake Song - Isobel Campbell & Mark Lanegan
300 Clouds - Nightlands
The High Road - Broken Bells
Il N'est Jamais Trop Tard - Cheikh Lo
Right On - The Roots
Round And Round - Ariel Pink's Haunted Graffiti
Devil's Spoke - Laura Marling
Colouring Of Pigeons - The Knife
Sign Of Love - Neil Young
Babelonia - School Of Seven Bells
Understand Me Now - Pretty Lights
A Rumour In Africa - Errors
Coma Cat - Tensnake
Modern Drift - Efterklang
Warbé - Ali Farka Touré
Love Cry - Joy Orbison remix - Four Tet
Waves - Holly Miranda
Mojo So Dope - Kid Cudi
Regenerate - Popof Remix - Booka Shade
Dance or Die - feat. Saul Williams - Janelle Monáe
Odessa - Caribou
Errare Humanum Est - Seu Jorge
Lost And Found - Steve Mason














2011

Mr. Brown - Zun Zun Egui
Vessel - Zola Jesus
Montana - Youth Lagoon
Flight - Wooden Shjips
Where Are Your People? - We Have Band
Brothers - The War On Drugs
Mad As the Mist and Snow - The Waterboys
Eyes Be Closed - Washed Out
I Am Not Like You - Ilya Santana Remix - Volta Cab
Chasing Rainbows - Ulrich Schnauss, Jonas Munk
Caffeinated Consciousness - TV On The Radio
My Country - tUnE-yArDs
Birds - Tiago Remix - Torn Sail
Take It Back - Toddla T
Tenere Taqqim Tossam - Tinariwen
Aratan N Tinariwen - Tamikrest
Ultra Light - Surkin
Arcane - Supervision
All Yours - Original Mix - Submotion Orchestra
Pull The House Down - Skellington Remix - Stricken City
Chunky Guitar - Space Ranger
Two Cousins - Slow Club
Sanctuary (feat. Jessie Ware and Sampha) - SBTRKT
War Machine - Reso
Star featuring Tony Momrelle - Manuel Tur Remix - Reel People
It's Real - Real Estate
How Deep Is Your Love? - The Rapture
Staircase - Radiohead
Written On The Forehead - PJ Harvey
Alabama Dice - Pional
Explain - Oneohtrix Point Never
Mexican Grand Prix - Mogwai
Africa - Rotciv Remix - Mirror People
Get Right - Megafaun
We Are You in the Future - Martyn
Can't Leave You - Maceo Plex
Ok Pal - M83
Witches - Low
Tale Of The Rogue Synth - Original Mix - Lord Of The Isles
Rise (feat. KRS ONE, A.P.O.S.T.L.E. & Stero-Lion) - Liquid Stranger
I Feel It - L-Vis 1990
Courage - Kyla La Grange
Society Is My Friend - Kurt Vile
Snowflake - Kate Bush
Supernova - Karsh Kale
Prizewinning - Julianna Barwick
Gabriel - Joe Goddard
Street - Jamie Woon
Salty Air - J.Viewz
Tree By The River - Iron & Wine
Oxblood - Implodes
Still Unloved - Icr
Winter Beats - I Break Horses
Phoenix - Hyetal
Still Life - The Horrors
Sceadu - Helge Lien Trio
These Are The Good Days - Gwilym Simcock
Tongue Tied - Grouplove
Sagrad Прекрасный - Grimes
Buy Nothing Day - The Go! Team
Up Up Up - Givers
Dead Man's Switch - Ghosting Season
EST - Gentleman's Dub Club
Under My Nose - Fucked Up
Rivers - Frank Turner
The Plains / Bitter Dancer - Fleet Foxes
Makoun Oumou - Fatoumata Diawara
(R E A L L O V E) - Factory Floor
Righteous featuring Danman - Main Mix - Evergreen, Landlord & Ruckspin
With Our Backs To The City - Epic45
My Mistakes - Eleanor Friedberger
Chrysalis Records - Egyptrixx
Complicity - The Early Years
Die 3 Millionen Musketiere - Dominik Eulberg
Waveforms - Django Django
Etran Duniya - The Dhol Foundation
Trumpalump - Joe Goddard Remix - Dels
Don't Carry It All - The Decemberists
Your Loft My Acid - Death In Vegas
Love/Lust - D/R/U/G/S
Palinopsia Intro/Almost Out of Time - D'eon
Go Outside - Cults
Cycle Eyes - Psychemagik Lagoon Nebula Mix - Cosmonauts
You And I Change Like Seasons - Codes In The Clouds
Ghost Story - Cloud Control
The Alliance (feat Talib Kweli) - Break Science
Teufelsleiter - The Brandt Brauer Frick Ensemble
Lavender - Blawan
Les Paul Custom '86 - Boris
Calgary - Bon Iver
Heavy Industry - The Black Dog
Hey Anna Lena - Bell X1
Reckless (With Your Love) - Tensnake Remix - Azari & III
Perfectly Crystal - Asobi Seksu
Another Time, Another Place - Arnaud Rebotini
Parentheses - The Antlers
You Know You Like It - DJ Snake
Take a Look Around - The 2 Bears


2012

Atmosphere - The Flowers Of Hell
Ten Thousand Years Won't Save Your Life - Hammock
Lazy Hunter - Boy Friend
Make You Feel Better - Cashier No. 9
Valentina - Iñigo Ugarteburu
1998 (Delicious) - Peace
Straight Back - Washed Out
Cheree - Füxa
Sparkly - Young Magic
Leave Your Body Behind You - Richard Hawley
Ashen Snow - Dirty Three
Mladic - Godspeed You! Black Emperor
Wasted Days - Cloud Nothings
Wait - Diiv
Travelling Song - Quantic
Autumn dub VIP - VIP Mix - Mooncat
The Guillotine - The Coup
Make It Happened (Original Mix) - BadBoe
Heart Full of Love - Fliptrix
Ruins - Portico Quartet
Good Morning - Leftside Wobble Remix - The Time And Space Machine
Catch - Psychemagik Remix - The Egg
The Same Disease - Michal Menert
First Snow - Original Mix - Chris.su
Hornet Head - Rene Lavice
Crystal Caverns 1991 - Lone
Icarus - Madeon
Exoframe - Reso
Big Beast - feat. Bun B, T.I., and Trouble - Killer Mike
Request Denied - El-P
Blue Narcissus - Omega Male
Bleeding Muddy Water - Mark Lanegan
Swimmers - Echo Lake
Toothless Grin - Jinja Safari
R. Mullen - Yppah
Dreams Today - Efterklang
Endless Ladder - The Antlers
Avatar - Swans
Njoka - Mokoomba
Doom And Gloom - Jeff Bhasker Mix - The Rolling Stones
ill Manors - Plan B
Let's Die - Turbowolf
Nexecution - Neonlight
Eraser - Neonlight Remix - Black Sun Empire
Crashed - Stay+
Just to Feel Anything - Emeralds
Gospel - Ross Caiden Remix - Tiger Stripes
Meeting Point - Utah Saints Remix - Drumattic Twins
We Got It Wrong - Original Version - St. Lucia
To a Poet - First Aid Kit
Varúð - Sigur Rós
How Do I Know - Here We Go Magic
Fire's Highway - Japandroids
Wrecking Ball - Bruce Springsteen
Hold On - Alabama Shakes
Little Talks - Of Monsters and Men
Twins - Ultrasound
Major - The Asteroids Galaxy Tour
Under The Bridges - Niki & The Dove
Get On It - Ruby Goe
Circumambient - Grimes
Stardust - Kolombo Remix - Cosmonauts
Don't Wait - Extended Mix - Alex Niggemann
Motion Sickness - Hot Chip
Heaven - The Walkmen
Monoliths - Lotus Plaza
Show Me Everything - Tindersticks
Running - Jessie Ware
Summer's Glory - Alcest
The Night - School Of Seven Bells
Walking Up To Hand Grenades - The Brian Jonestown Massacre
Brats - Liars
Underbelly - The Slow Waves
Dark Star - POLIÇA
Waterfront - Enjoyed
Her Fantasy - Matthew Dear
Be Loved - Richard Fearless & Death in Vegas Remix - Headman aka Robi Insinna
Beelzedub - Orbital
White Math - Blanck Mass
London Can Take It - Public Service Broadcasting
Current - Jonas Munk
Dream Beat - Peaking Lights
Pushin` Aside, Pushin` Along - De La Soul`s Plug 1 & Plug 2 present First Serve
Dougou Badia - feat. Santigold - Amadou & Mariam
Goatman - Goat
Black Doe - Mary Epworth
Vultures - Sennen
Tessellate - alt-J
Changuito - Mala
Mallet - Walton
De Javu - Mark McGuire Remix - Lindstrøm
OC DC - Get The Blessing
Out of Line - Brothertiger
When The Past Was Present - John Talabot
My Advice - Peter Visti
Pleasure Palaces - Errors
Diamondback (Part 1 & Part 2 - Extended Single Version) - (Part 1 & Part 2 - Extended Single Version) - Sare Havlicek
Night Swim - Frankie Rose




2013

Look Into Your Own Mind - Julianna Barwick
Help - Postiljonen
This Is The Last Time - The National
We Are Explorers - Cut Copy
What Death Leaves Behind - Los Campesinos!
Penitentiary - Houndmouth
Bibisa - Roberto Fonseca
Green And Gold - Lanterns on the Lake
Hearts Like Ours - The Naked And Famous
One Girl / One Boy - !!!
Hipsko (feat. The Time Travellas) - Timewarp Inc
The Corner Man - Barrence Whitfield & The Savages
Coming Through - Willis Earl Beal feat. Cat Power
Moonshine Got Me (Live) - Daniel Norgren
Recollection - Keep Shelly In Athens
On My Own - Dub Version - Zero 7
White Ropes - Mixhell
Video Siren - Gary Beck
Hemlock - Concord Dawn
Aurora - Camo & Krooked
Out of Sight - The Bloody Beetroots
Full of Fire - The Knife
You Show Great Spirit - Prurient
Brennisteinn - Sigur Rós
Spectral Split - Pantha Du Prince & The Bell Laboratory
The Only Constant Is Change - Kris Menace
Survive - Kidnap Kid
The Throw - Jagwar Ma
Fire! - Steve Mason
I Come From The Mountain - Thee Oh Sees
In Awe Of - Cult Of Luna
Spit Dirt - His Electro Blue Voice
Stay True - PINS
Dancing Light - Grumbling Fur
V (Island Song) - These New Puritans
Fall Back - Factory Floor
New Seeds - Boards of Canada
Mr. Martyr - Young Fathers
Spiral Code - God Is An Astronaut
Still On Fire - Trentemøller
So Inspired To Fail - Rene Lavice
Badman City - Kahn
Renata - Holden
Inner Babylon - Sons Of Kemet
Reaper - Teeth Of The Sea
Bleep Five - The Black Dog
Come Down to Us - Burial
Make Those Move - I Am Legion
Hate Or Glory - Gesaffelstein
Ghost Town - Maldini
Release! - Melt Yourself Down
People Will Say - Benin City
Gamo - Mulatu Astatke
Run Boy Run - Woodkid
Where Are We Now? - David Bowie
Jubilee Street - Nick Cave & The Bad Seeds
Where Do We Go from Here (feat. Menahan Street Band) - Charles Bradley
Bapasi - Jupiter & Okwess International
White Noise - Disclosure
Spitfire - Public Service Broadcasting
Spiral - Todd Terje
My Baby Just Sailed Away - Black Hearted Brother
Afterlife - Arcade Fire
Son of a Bitch - Highasakite
Sounds Like There's A Pacman Crunching Away At Your Heart - Haiku Salut
Wakin on a Pretty Day - Kurt Vile
Special N - Mogwai
Ohm - Yo La Tengo
Falling - Haim
Somebody Who - Au Revoir Simone
Bad Kingdom - Moderat
Cirrus - Bonobo
Billions - Forrests
Things Are Sometimes Tragic - Team Ghost
Amanda In the Clouds - Panda Riot
Inhaler - Foals
Punk Music Mass - AK/DK
Prisms - 65daysofstatic
Brainfreeze - Fuck Buttons
We Live - 126 Refix - Greg Packer
Open Eye Signal - Jon Hopkins
Ghost Mountain You And Me - Thought Forms
If I Were A Carpenter - Smoke Fairies
Big Love - Matthew E. White
9 - Föllakzoid
They Won't See Me - The Field
Touching - Raffertie
Beglammered - The Asphodells (Andrew Weatherall & Timothy J Fairplay)
Hare Tarot Lies - No Joy
Bagboy - Pixies
Imanin bas zihoun - Tamikrest
Red Eyes - The War On Drugs
Colour Yr Lights In - The Besnard Lakes
The Revival - Hidden Orchestra
Barrier Islands (Do We Remain) - The Appleseed Cast
These Shadows - Wooden Shjips
The Only Shrine I've Seen - Darkside
Stay / True - Fort Romeau
The Trip - Still Corners


